NO ./path_to_the_north_texture.png
SO ./path_to_the_south_texture.png
WE ./path_to_the_west_texture.png
EA ./path_to_the_east_texture.png

C 225,30,0
F 220,100,0

1111111111111111111111
1000000000110000000001
1011000001110000000001
1001000000000000000001
1111111110110000011101
1000000000110000011101
1111011111111101110001
1111011111111101110101
1100000011010101110001
1000N00000000000110011111111111
1000000000000001101011
1100000111010101111101
1111011111010101111101
1111111111111111111111